10
+--+--+--+--+--+--+--+--+--+--+
      |  |     |        |     |
+--+  +  +--+  +  +--+--+--+  +
|     |                 |  |  |
+--+  +--+  +--+--+  +  +  +  +
|           |  |  |  |     |  |
+--+  +--+  +  +  +--+--+--+  +
|     |  |  |  |  |           |
+  +--+  +--+  +  +  +--+--+--+
|        |     |        |     |
+--+  +--+--+  +  +  +--+  +  +
|     |     |     |  |  |  |  |
+--+  +  +  +  +  +  +  +--+  +
|        |     |  |           |
+  +--+--+--+  +--+--+--+  +--+
|  |  |           |  |     |  |
+  +  +  +  +  +  +  +--+  +  +
|     |  |  |  |     |  |     |
+--+--+  +--+  +  +--+  +  +  +
|           |  |  |        |
+--+--+--+--+--+--+--+--+--+--+
