13
+--+--+--+--+--+--+--+--+--+--+--+--+--+
      |           |  |                 |
+  +--+--+  +--+--+  +--+--+  +--+--+--+
|  |  |     |           |     |  |     |
+  +  +--+  +  +--+--+--+  +--+  +--+  +
|  |     |  |     |  |     |  |     |  |
+  +  +--+  +--+  +  +  +  +  +  +--+  +
|     |  |  |           |     |        |
+--+  +  +  +--+--+  +  +--+--+  +--+--+
|           |     |  |  |     |     |  |
+  +--+  +--+  +  +  +--+--+  +--+  +  +
|  |     |     |        |  |  |        |
+--+  +--+--+--+  +--+  +  +  +  +  +--+
|        |        |     |     |  |     |
+--+--+  +  +  +--+--+  +--+  +  +--+--+
|  |  |  |  |     |  |  |              |
+  +  +  +  +--+  +  +--+  +--+  +--+--+
|        |  |     |           |     |  |
+  +--+  +--+  +--+  +--+--+--+--+  +  +
|  |              |        |           |
+  +--+--+  +--+--+--+  +  +--+  +  +  +
|     |                 |  |  |  |  |  |
+--+--+--+--+  +--+  +--+--+  +--+--+--+
|        |        |     |           |  |
+  +  +--+  +--+  +--+  +  +--+--+  +  +
|  |           |     |     |            
+--+--+--+--+--+--+--+--+--+--+--+--+--+
