15
+--+--+--+--+--+--+--+--+--+--+--+--+--+--+--+
                  |  |              |  |     |
+  +--+  +--+--+--+  +  +--+--+--+--+  +  +  +
|  |  |              |     |     |     |  |  |
+  +  +  +--+  +  +--+--+  +--+  +--+  +--+  +
|  |     |     |           |        |        |
+  +  +  +--+--+--+  +--+--+--+  +--+--+--+  +
|  |  |        |                 |  |  |     |
+--+  +--+  +--+  +  +--+--+  +--+  +  +  +--+
|     |     |     |     |                    |
+  +--+--+--+--+  +--+  +  +--+--+--+--+  +--+
|  |        |        |  |  |           |     |
+--+  +--+  +  +--+  +--+  +  +--+  +  +  +  +
|        |  |  |        |  |  |  |  |  |  |  |
+--+--+  +  +--+  +--+  +--+--+  +  +--+  +--+
|        |     |  |     |           |        |
+--+  +--+--+  +  +--+  +--+--+  +  +  +--+  +
|  |  |  |           |  |     |  |     |     |
+  +--+  +  +  +--+--+  +--+  +  +  +--+  +--+
|        |  |     |        |  |  |     |     |
+--+  +--+--+  +--+--+--+  +  +--+--+--+--+  +
|  |        |  |  |  |  |  |        |     |  |
+  +  +  +--+  +  +  +  +  +  +  +--+  +--+  +
|     |        |     |        |  |  |  |  |  |
+--+--+--+  +--+  +  +  +--+--+  +  +  +  +--+
|        |        |  |  |  |  |        |     |
+--+  +  +--+  +--+--+  +  +  +  +--+--+  +  +
|  |  |        |           |  |           |  |
+  +  +--+--+--+--+  +--+  +  +  +  +--+  +  +
|     |                 |     |  |     |  |   
+--+--+--+--+--+--+--+--+--+--+--+--+--+--+--+